0 0 0 0 0 0 0 0 0 0 0 0
1 5 5 0 0 0 0 0 0 3 0 0
0 0 0 0 2 0 0 0 0 0 0 0
0 0 0 0 0 0 0 0 0 0 0 0
0 0 0 0 0 0 0 0 0 5 0 0
0 0 0 0 0 0 0 0 0 0 0 0
0 0 0 1 0 0 0 0 3 0 0 0
0 0 5 0 0 2 0 0 0 0 0 0
0 0 0 0 0 0 0 0 0 0 0 0
0 0 0 0 0 0 0 0 0 0 1 0
0 0 0 0 0 0 0 0 0 0 1 0
0 0 0 3 0 0 0 0 1 0 0 0
2 0 0 0 0 0 0 0 0 0 5 3
4 2 0 0 0 0 0 0 0 0 1 0