5 0 0 1 0 0 0 0 5 0 2 5
0 0 0 1 0 0 0 1 0 0 0 0
0 0 0 1 0 0 0 1 0 2 0 0
0 0 0 1 0 0 0 1 0 0 0 0
1 3 1 1 0 0 0 1 1 3 1 1
3 0 0 0 0 0 0 0 0 0 0 0
0 0 0 0 0 0 0 0 0 0 0 0
0 0 0 0 0 3 0 0 0 3 2 2
0 0 0 0 3 4 3 0 0 0 3 5
1 1 1 0 0 3 0 0 0 0 0 0
0 1 0 0 1 0 1 0 0 0 0 0
0 0 0 0 1 0 1 0 0 0 0 0
5 0 0 0 0 0 0 0 0 0 0 0
1 1 1 3 1 0 1 0 0 0 3 3